6 6
+ _ _ _ _ +
] . P . G [
] ═ ▄ ═ . [
] + . + . [
] ] . | . [
H . . - - +
0 1
0 1
-1 0
-1 0
-1 0
-1 0
0 1
0 1