12 12
+ _ _ _ _ _ _ _ _ _ _ +
] ═ ╗ ═ ╗ . ╔ ═ ═ ═ G [
] + ║ . ║ . ║ | ║ | . [
] + █ | ║ | ║ | ║ | . [
] + ║ . ║ | ║ | ║ . E [
] + ║ | █ | █ | + + + [
] + ║ | ║ P ║ | + + + [
] + ║ | ║ - ║ | + + + [
] . . + + + + | + + + [
] . + + + + + + + + + [
] . . . . H + + + + + [
+ - - - - - - - - - - +
0 -1
0 -1
0 -1
0 -1
-1 0
-1 0
0 1
-1 0
-1 0
-1 0
-1 0
-1 0
-1 0
-1 0
0 1
0 1
1 0
1 0
1 0
1 0
1 0
0 1
0 1
-1 0
-1 0
-1 0
-1 0
-1 0
0 1
0 1
1 0
1 0
1 0
0 1
0 1
-1 0
-1 0
-1 0