12 12
+ _ _ _ _ _ _ _ _ _ _ +
] H | . . . . . . . . [
] . | . + + + + + + . [
] . . . + . . P . + . [
+ + + + + ╔ ▄ ═ ═ ╗ . [
] . . . . ║ + + + + + [
] . + + + █ + + + ║ G [
] . . . . ║ . . + █ . [
] + + + + ║ + . . ║ + [
] + + + + ╚ ═ ═ ▄ ╗ + [
] + + + + + + . . ║ + [
+ - - - - - - - - - - +
1 0
1 0
0 1
0 1
-1 0
-1 0
0 1
0 1
0 1
0 1
0 1
0 1
0 1
1 0
1 0
1 0
0 -1
0 -1
0 -1
0 -1
0 -1
1 0
0 -1
0 -1
0 -1
0 -1
1 0
1 0
0 1
0 1
0 1
0 1
0 1
0 1
1 0
1 0
0 1
0 1
-1 0
-1 0
0 1
-1 0